6 7 7 6 6 5 5 5 6 8 8 6 4 5 6
3 5 6 5 5 5 3 3 4 5 6 4 3 4 5
1 4 5 5 6 6 4 2 1 3 6 6 4 5 6
3 5 6 5 6 7 6 4 3 4 7 7 6 6 7
6 8 7 5 6 7 8 7 5 5 6 5 4 6 7
9 10 8 6 6 8 8 7 6 5 4 3 3 6 8
9 9 7 6 7 7 5 5 5 6 4 4 4 6 8
6 6 5 5 6 6 3 4 6 7 6 5 6 6 6
5 5 4 4 5 5 4 5 8 8 6 6 6 5 4
5 4 4 5 6 6 5 6 8 8 7 6 6 5 3
6 4 4 6 7 7 5 5 6 7 6 5 6 5 5
6 4 3 5 6 6 4 4 6 7 6 5 6 6 6
4 2 1 3 4 4 4 6 7 8 6 5 6 6 5
4 3 2 2 1 1 3 6 8 8 6 5 6 6 6
4 6 6 4 2 0 1 5 7 7 6 5 6 7 7
