115 190 190 120 75 80 110 105 85 100 130 105 95 135 150 125 110 80 85 120 140 120 115 110 105
85 150 155 110 95 130 170 175 150 150 165 150 145 185 215 185 155 85 35 55 65 45 45 60 95
110 110 95 115 150 165 190 215 185 145 140 135 170 215 260 215 145 70 45 50 45 40 45 55 75
115 85 60 105 150 120 110 155 155 120 100 80 100 150 210 170 90 55 95 105 95 95 110 105 90
85 60 25 65 110 80 60 95 115 110 95 55 50 75 135 120 60 55 125 140 135 135 140 125 95
70 70 10 30 95 130 100 85 75 90 110 125 100 65 50 70 85 105 130 140 155 145 120 70 45
105 120 75 85 155 185 130 85 60 95 135 185 150 80 25 75 125 145 115 120 145 145 105 40 35
150 165 135 155 210 185 105 60 55 100 130 165 120 50 15 80 135 150 130 130 155 160 135 90 100
190 165 135 160 200 180 115 75 55 60 65 100 75 15 0 75 120 165 175 170 155 160 185 210 215
140 90 75 115 145 160 125 100 95 90 80 115 115 60 30 85 120 150 150 135 90 85 145 220 205
75 40 65 110 135 150 120 100 135 165 155 180 165 110 75 110 135 125 75 50 10 10 70 140 125
65 90 115 110 115 165 165 130 150 190 195 185 130 90 120 175 160 110 35 -20 -50 -25 5 25 35
110 175 180 115 95 145 155 110 85 125 150 150 105 75 135 170 120 105 110 50 25 65 70 35 40
110 175 180 115 80 95 90 45 40 80 115 160 155 130 140 125 65 100 170 130 105 145 150 95 70
100 115 115 65 30 50 80 75 50 35 40 90 125 120 145 130 70 65 130 135 145 190 215 165 70
105 75 90 75 35 45 110 150 140 80 50 45 80 100 160 160 100 30 55 105 120 120 165 155 70
110 85 140 145 85 45 85 140 180 155 120 100 125 145 170 135 75 25 80 140 125 70 100 120 95
70 70 145 165 120 35 35 85 170 215 215 165 135 155 125 70 50 50 90 135 135 100 120 150 170
65 75 105 120 105 60 60 80 100 150 200 155 100 115 75 50 100 120 90 100 135 150 150 170 185
130 135 120 115 115 105 120 125 65 70 135 130 105 130 95 85 150 170 125 125 135 110 95 110 130
180 180 145 130 140 180 205 185 95 75 115 125 115 130 120 135 185 195 145 130 135 110 75 60 60
140 155 140 125 140 195 190 150 130 135 135 125 110 100 105 140 160 165 130 100 125 165 120 65 60
110 130 130 110 120 145 115 75 80 105 100 115 125 105 90 100 110 140 140 110 125 155 95 55 105
145 150 105 70 75 105 85 35 30 50 55 100 130 110 60 40 65 150 195 165 130 110 75 80 155
165 165 100 50 60 120 125 75 40 60 85 110 110 95 25 15 75 195 230 170 85 70 115 160 175
