6 7 10 12 13 13 12 11 9 7 6 4 3 2 2 2 3 4 5 5 6 5 5 5 4 3 3 3 4 5 6 6 7 7 6 5 4 4 4 5 6 7 8 8 9 9 8 7 6 6
4 6 9 11 12 12 12 10 8 6 5 4 3 2 2 3 4 5 6 6 7 7 6 6 5 5 4 5 5 6 7 8 8 8 7 6 5 5 5 5 6 7 8 9 10 10 9 8 8 7
4 6 8 9 11 11 11 9 8 6 5 4 3 3 3 4 5 6 7 8 8 8 8 8 7 6 6 6 7 7 8 9 9 9 8 7 6 6 6 7 7 9 10 11 11 11 11 10 9 9
3 5 7 8 10 10 10 8 7 6 5 4 4 4 4 5 6 8 9 10 10 10 10 10 9 8 8 8 8 8 9 10 10 10 9 8 8 7 8 8 9 10 11 12 13 13 13 12 11 10
4 5 6 7 8 8 8 7 6 6 5 5 5 5 6 7 8 9 11 11 12 12 12 12 11 10 9 9 9 9 9 10 10 10 9 9 9 9 9 10 11 12 13 14 15 15 15 14 13 11
4 5 6 6 7 7 6 6 6 6 6 6 6 7 7 8 9 10 11 12 13 13 13 13 12 11 10 9 9 9 9 9 9 9 9 9 9 9 10 11 12 13 14 15 16 17 16 15 14 12
5 5 6 6 5 5 5 5 5 5 6 7 8 8 9 9 10 10 11 12 13 13 14 14 13 12 11 9 9 8 8 8 8 8 8 8 8 9 10 11 12 13 14 16 17 17 17 15 14 12
6 6 6 5 4 4 3 4 4 5 6 7 8 9 9 9 9 10 10 10 11 12 13 13 13 12 10 9 8 7 7 7 7 6 6 6 7 8 9 10 11 12 14 15 16 17 16 15 13 11
6 6 5 4 3 3 2 3 4 5 6 8 9 9 9 9 9 8 8 9 9 10 11 12 12 11 10 8 7 7 6 6 6 5 5 5 5 6 7 8 9 11 12 14 15 16 15 14 12 10
6 6 5 4 3 2 1 2 3 4 6 8 9 9 9 8 7 6 6 6 7 8 9 10 10 10 9 8 7 6 6 5 5 4 4 3 4 4 5 6 8 9 10 12 14 14 14 13 11 9
6 5 5 3 2 1 1 1 2 4 6 7 8 8 8 7 6 5 4 5 6 7 8 8 9 9 8 7 7 6 6 5 5 4 3 2 2 3 3 4 6 7 8 10 12 13 13 12 10 8
5 5 4 3 2 1 0 1 2 3 5 6 7 8 7 6 4 3 3 3 4 5 6 7 8 8 8 7 6 6 5 5 4 3 2 1 1 1 2 3 4 5 6 8 10 11 11 10 9 6
4 4 3 2 1 0 -1 0 1 2 4 5 6 6 6 5 3 2 1 2 2 3 4 5 6 7 7 6 6 5 5 5 4 3 2 1 0 0 0 1 2 3 5 6 8 9 10 9 7 5
3 3 3 2 0 -1 -2 -2 -1 1 2 4 5 5 5 4 3 2 1 1 2 3 3 4 5 5 6 5 5 5 5 5 4 3 2 1 0 0 0 1 1 2 3 4 6 7 7 7 6 4
2 3 2 1 0 -2 -2 -3 -2 -1 1 2 3 4 5 4 4 3 2 2 2 2 3 3 4 4 4 4 4 4 4 4 4 4 3 2 2 1 1 1 1 1 2 3 4 5 5 5 4 3
2 2 2 1 0 -1 -3 -3 -3 -2 0 1 3 4 5 5 5 4 4 3 3 3 3 3 3 3 3 3 4 4 4 4 5 5 5 4 4 3 3 2 2 2 1 2 2 2 3 3 3 3
2 3 3 2 1 -1 -2 -3 -3 -2 -1 1 3 5 6 7 7 6 5 5 4 4 3 3 3 2 2 3 3 4 4 5 5 6 6 6 6 6 5 4 3 2 2 1 1 1 1 2 2 3
3 4 4 3 2 1 -1 -2 -2 -1 0 2 4 6 7 8 9 8 7 6 6 5 4 3 2 2 2 2 3 4 4 5 6 7 8 9 9 8 7 6 4 3 2 1 0 -1 0 1 2 3
4 5 5 5 4 2 1 0 0 0 2 3 5 7 9 10 10 10 8 7 6 5 4 3 2 2 2 2 3 4 5 5 6 8 9 10 10 10 8 7 6 4 2 1 -1 -1 -1 1 2 3
5 6 6 6 5 4 2 2 2 2 4 5 7 9 10 11 11 10 9 7 6 5 4 3 2 1 2 2 3 4 5 6 7 9 10 11 11 10 9 7 6 4 2 0 -1 -1 -1 1 2 4
6 7 7 7 6 5 4 3 3 4 6 7 9 10 12 12 11 10 8 7 6 4 3 2 1 1 2 3 4 5 6 6 8 9 10 11 11 10 9 7 6 4 2 0 -1 -1 -1 1 2 4
6 8 8 8 8 7 6 5 5 6 7 9 10 12 12 12 11 9 7 6 5 4 2 1 1 1 2 3 4 5 6 7 8 9 10 11 11 10 8 7 5 3 1 0 -1 -2 -1 1 3 4
8 9 10 9 9 8 7 7 7 8 9 10 12 13 13 13 11 9 7 5 4 3 2 1 1 1 1 3 4 5 6 6 7 9 10 10 10 9 7 5 4 2 0 -1 -2 -2 -1 1 3 5
10 10 11 11 10 9 8 8 8 9 10 12 13 14 14 13 11 9 7 5 4 3 2 1 0 0 1 2 3 4 5 5 6 7 8 9 8 7 6 4 2 1 -1 -2 -3 -3 -1 1 3 4
11 12 12 11 10 9 9 8 9 9 11 12 13 14 14 13 11 9 7 5 4 3 2 1 1 0 1 1 2 3 3 4 4 5 6 7 7 6 4 3 1 0 -2 -3 -4 -3 -2 0 3 4
12 12 11 11 10 9 8 8 8 9 10 11 12 13 13 12 11 9 7 6 5 4 3 2 1 1 1 1 2 2 2 2 3 4 4 5 5 4 3 2 0 -1 -3 -4 -4 -3 -2 0 3 4
12 11 10 9 8 7 7 7 7 8 9 10 11 12 12 12 11 9 7 6 5 4 3 3 2 1 1 1 1 1 1 1 2 2 3 4 4 4 3 2 0 -1 -3 -4 -4 -3 -2 1 3 4
11 10 9 7 6 5 5 5 6 7 8 9 10 10 11 11 10 9 8 7 6 5 4 3 3 2 2 2 2 2 1 1 1 2 3 4 4 4 4 2 1 0 -2 -3 -3 -3 -1 1 3 4
9 8 7 5 4 4 3 4 5 6 6 7 8 9 10 10 10 9 8 7 6 5 5 4 4 3 3 3 3 3 2 2 2 3 4 5 5 5 5 4 2 1 -1 -2 -2 -2 0 1 3 4
7 6 5 3 2 2 2 3 4 5 6 6 7 8 9 10 9 9 8 7 6 5 5 4 4 4 4 4 4 4 4 3 3 4 5 6 7 7 6 5 4 2 1 0 -1 -1 0 2 3 4
6 4 3 2 1 1 2 3 4 5 6 6 7 8 9 9 9 8 7 6 6 5 4 4 4 5 6 6 6 6 6 5 5 6 7 8 8 8 8 7 6 4 3 1 0 0 1 2 4 5
4 3 2 1 0 0 1 2 4 5 5 6 7 8 9 9 9 8 7 6 5 4 4 4 5 6 7 8 8 8 7 7 7 8 8 9 10 10 9 8 7 5 4 2 2 1 2 3 4 5
2 1 0 0 0 0 1 2 4 5 5 6 7 8 8 9 9 8 7 6 5 5 4 5 5 7 8 9 10 10 9 9 9 10 10 11 11 11 10 9 8 6 5 3 3 2 3 4 5 6
1 1 0 0 0 1 2 3 4 5 5 6 6 7 8 9 9 9 8 7 6 6 5 5 6 8 9 10 11 11 11 11 11 11 12 12 12 11 10 9 7 6 5 4 4 4 5 6 7 8
1 1 1 1 2 2 3 4 5 5 5 5 6 7 8 9 9 10 9 8 8 7 6 6 7 8 9 11 12 12 12 12 12 12 12 12 11 10 9 8 7 5 4 4 4 5 6 8 9 9
2 2 2 3 4 5 5 6 6 5 5 5 5 6 7 9 10 10 10 10 9 8 7 7 7 8 9 10 11 12 12 12 12 12 12 12 10 9 8 6 5 4 4 4 5 6 8 9 10 10
3 3 4 6 7 7 7 7 7 6 5 5 5 6 7 8 10 11 11 10 9 8 7 7 7 7 8 9 10 11 11 11 12 12 11 11 9 8 6 5 4 3 3 4 5 7 9 10 11 11
4 5 7 8 9 10 9 9 7 6 5 4 4 5 6 8 9 11 11 10 9 8 7 6 6 6 6 7 8 9 10 10 10 11 10 10 8 7 5 4 3 2 2 3 5 7 9 11 11 11
5 6 8 10 11 11 11 10 8 7 5 4 4 4 6 7 9 10 10 10 9 7 6 5 4 4 4 5 6 7 8 8 9 9 9 9 8 7 5 4 3 2 3 4 5 8 9 11 11 10
6 7 9 11 12 12 12 10 8 7 5 4 4 4 5 6 8 9 9 8 7 6 5 3 3 2 3 4 5 6 6 7 8 8 9 9 8 7 6 5 4 3 3 4 6 8 9 10 10 9
6 7 9 11 12 12 12 10 9 7 6 4 4 4 4 5 6 7 7 7 6 4 3 2 1 1 2 3 4 5 6 6 7 8 9 9 9 8 7 6 6 5 5 5 7 8 9 9 8 7
5 7 9 10 12 12 12 10 8 7 5 4 4 3 4 4 5 6 5 5 4 3 1 0 0 0 0 2 3 4 5 5 6 7 9 9 10 9 9 8 7 6 6 7 7 8 8 8 7 6
5 7 8 10 11 11 11 9 8 6 5 4 3 3 3 3 4 4 4 3 2 1 0 -1 -1 -1 0 1 2 3 3 4 5 6 8 9 9 10 9 9 8 7 7 7 8 8 8 7 6 5
5 6 7 9 10 10 9 8 6 5 4 2 2 1 1 2 2 3 3 3 2 1 0 -1 -1 -1 -1 0 1 1 2 2 3 4 6 7 8 9 9 9 8 7 7 8 8 8 8 7 6 4
5 5 6 7 8 8 7 6 5 4 2 1 0 0 0 0 1 2 3 3 2 2 1 1 0 0 0 0 0 0 0 0 1 2 4 5 6 7 8 8 7 7 7 7 8 8 8 7 6 5
5 5 5 5 6 6 5 5 4 2 1 0 -1 -1 -1 -1 0 2 3 3 3 3 3 3 2 1 1 0 0 -1 -1 -1 0 0 1 3 4 5 6 6 6 6 6 7 8 8 9 8 7 6
5 4 4 4 4 4 4 4 3 2 1 0 -1 -2 -2 -1 0 2 3 4 4 5 5 5 5 4 3 2 1 0 -1 -1 -1 -1 0 1 2 3 4 5 5 5 5 6 8 9 9 9 8 7
5 4 3 3 3 3 3 3 3 2 1 0 -1 -2 -2 -1 0 2 3 5 6 6 7 7 7 6 5 4 2 1 0 0 -1 -1 -1 0 1 2 3 3 4 4 5 6 8 9 10 10 9 8
5 4 3 3 3 3 4 4 4 3 2 1 0 -1 -1 -1 0 2 4 5 6 7 8 9 9 9 7 6 4 3 2 1 0 0 0 0 1 2 2 3 3 4 5 6 8 9 10 10 9 8
5 4 3 3 3 4 4 5 5 5 4 3 1 0 0 0 0 2 4 5 6 7 9 10 10 10 9 8 6 5 4 3 2 1 1 1 1 2 3 4 4 5 6 7 9 10 10 10 9 8
