5 2 0 0 2 5 6 7 7 5 5 4 5 6 5
6 4 1 0 1 3 5 6 6 4 4 4 4 5 4
7 5 2 1 2 3 5 5 4 3 2 2 3 3 3
6 5 3 2 3 5 5 5 3 2 2 2 2 3 3
5 4 3 3 4 5 6 5 4 3 3 3 3 3 3
5 4 3 3 4 5 5 5 5 4 5 5 4 3 3
5 4 3 2 2 3 4 4 5 6 6 6 5 3 3
6 5 4 3 2 2 2 4 5 6 6 5 4 3 3
6 6 5 5 4 3 2 3 5 6 5 4 3 3 3
5 6 6 7 5 4 3 3 5 5 4 2 2 4 4
5 5 6 7 6 5 3 4 5 6 5 3 3 4 5
4 4 6 7 6 5 4 5 6 7 5 4 4 5 6
4 4 6 6 6 5 5 5 6 6 4 3 3 4 5
5 5 5 6 6 5 6 6 5 4 3 2 2 3 4
5 5 5 5 5 5 6 6 5 4 3 2 2 3 4
