43 43 43 33 33 23 23 23 33 43 53 63 73 63 53 43 43 33 33 33 33 33 33 33 33
43 43 43 33 23 13 13 13 23 33 43 63 63 63 63 53 53 43 43 33 33 33 33 33 43
43 43 43 33 23 13 13 13 23 33 43 53 63 63 63 53 53 43 43 43 43 43 43 43 43
43 43 43 33 23 13 13 13 23 23 43 53 53 63 53 53 43 43 43 43 43 43 43 53 53
43 43 43 33 23 23 13 23 23 33 43 43 53 53 53 43 43 33 33 33 43 43 53 63 63
43 43 33 33 33 23 23 23 33 33 43 43 43 43 43 33 33 23 23 33 33 43 53 63 63
33 33 33 33 33 33 33 33 43 43 43 43 43 43 33 33 23 23 23 23 33 43 53 63 63
33 33 33 33 33 33 33 43 43 43 43 43 43 43 33 33 33 23 23 23 33 43 53 53 53
33 33 33 33 33 33 33 33 43 43 43 43 43 43 43 43 33 33 33 33 33 43 43 43 43
43 33 33 33 33 33 33 33 33 33 43 43 43 53 53 53 43 43 43 43 43 43 43 43 33
33 33 33 33 23 23 23 33 33 33 33 43 43 53 53 53 53 53 43 43 43 43 33 33 33
33 23 23 23 23 23 23 33 33 33 33 43 43 53 53 53 53 53 43 43 33 33 33 33 33
23 13 13 13 13 23 23 33 33 33 33 33 43 43 53 53 43 43 33 33 33 23 33 33 33
13 13 3 3 13 23 33 33 33 33 33 33 43 43 43 43 43 33 23 23 23 23 23 33 43
13 3 3 3 13 23 33 43 43 33 33 33 33 43 43 33 33 23 23 13 13 13 23 33 43
23 13 3 3 13 23 33 43 43 33 33 33 33 43 43 33 33 23 13 13 3 3 13 23 43
33 23 13 13 23 33 43 43 43 33 33 33 43 43 43 43 33 33 23 13 3 3 3 23 33
43 33 23 23 23 33 43 43 43 33 33 33 43 43 53 53 43 43 33 13 3 3 3 13 23
53 43 33 23 33 33 33 33 33 33 33 33 43 53 53 63 53 43 33 23 3 -7 -7 3 13
53 43 33 33 33 33 33 33 23 23 23 33 43 53 63 63 63 53 43 23 3 -7 -17 -7 3
43 43 33 33 33 33 23 23 23 13 13 23 33 53 63 63 63 53 43 23 3 -7 -17 -17 -7
43 33 33 33 33 23 23 23 13 13 13 23 33 43 63 63 63 53 43 23 3 -7 -17 -17 -7
33 33 33 33 33 33 23 23 13 13 13 13 33 43 53 53 53 43 33 23 3 -7 -17 -7 -7
23 33 33 43 43 33 33 23 23 13 13 23 33 43 53 53 43 43 33 13 3 -7 -7 3 13
33 33 43 43 43 43 43 33 33 23 23 23 33 43 43 43 43 33 23 13 3 -7 3 13 23
