5 6 6 5 5 5 5 4 4 4
3 4 5 5 4 4 4 4 3 2
1 2 4 4 4 4 4 4 2 1
1 2 4 4 4 4 5 5 3 2
2 4 5 5 4 5 5 6 5 4
5 6 6 5 4 5 5 7 7 6
6 8 8 6 5 5 6 7 8 7
8 9 8 6 5 5 6 7 7 6
8 8 7 6 5 6 6 5 4 3
6 6 5 5 5 5 6 4 2 2
